8 8
0 34
. . . . . . . . 
. . X . . . . . 
. . m ~ . ~ . . 
. . X . ~ m . ~ 
. o . . o . . . 
. . . ^ ^ . . ~ 
. . m . . . . . 
. . . . . . . . 

